../assets/tile_sheets/bigTileSheetWarehouseSecurity.txt
MAP_START
38,38,38,38,38,38,38,38,38,38
0,0,0,0,0,0,0,0,0,0
0,0,0,0,0,0,0,0,0,0
0,38,905,904,904,904,904,38,38,38
0,38,905,38,904,904,904,38,906,38
0,38,905,904,904,38,904,38,0,38
0,38,905,904,893,904,904,38,0,38
0,38,905,892,892,892,892,38,0,38
0,38,38,38,38,38,38,38,0,38
0,0,0,0,0,0,0,0,0,38
MAP_END
ENTITIES_START
1,9,1
2,1,2
7,8,8
2,3,2
2,4,2
2,5,2
2,6,2
2,8,2
6,2,7
ENTITIES_END
CONTACTS_START
9,3
CONTACTS_END
../assets/levels/official/_iceSwitchPalace.txt