../assets/tile_sheets/bigTileSheetWarehouseSecurity.txt
MAP_START
91,91,91,92,319,320,891,825,296,297,298,822,890,319,320,329,330,331,620,620,74,74,74,74,74,74,74,74,74,906
91,91,91,92,356,357,891,862,333,334,335,859,890,356,357,366,367,367,9,10,2,235,160,161,160,161,160,161,234,235
91,899,91,92,393,394,26,26,27,28,29,30,30,393,394,403,404,405,46,47,39,272,197,198,197,198,197,198,271,272
246,193,251,245,430,431,63,63,64,65,66,67,67,430,431,440,441,442,83,84,321,322,323,324,325,326,327,328,244,244
283,230,288,282,467,468,100,100,101,102,103,104,104,467,468,329,330,331,120,121,358,359,360,361,362,363,364,365,244,244
190,74,190,74,319,320,137,137,138,139,140,141,141,319,320,366,367,368,157,158,395,396,397,398,399,400,401,402,244,244
74,190,74,190,356,357,174,174,175,176,177,178,178,356,357,403,404,405,194,195,432,433,434,435,436,437,438,439,244,244
190,74,519,74,393,394,12,13,13,13,13,13,14,393,394,440,441,442,231,232,469,470,471,472,473,474,475,476,244,244
74,190,74,190,430,431,49,902,902,902,902,902,51,430,431,12,13,14,234,235,506,507,508,509,510,511,512,513,244,244
190,74,190,74,467,468,49,902,902,902,902,902,51,467,468,49,902,51,271,272,543,544,545,546,547,548,549,550,244,244
74,190,74,190,319,320,49,902,902,902,902,902,51,12,87,88,902,51,17,18,580,581,582,583,584,585,586,587,244,244
190,74,190,74,356,357,86,87,87,87,87,87,88,49,902,902,902,51,54,55,612,613,614,614,615,616,618,619,244,244
76,227,227,227,393,394,123,124,124,124,124,124,125,86,87,87,87,88,215,215,215,215,215,215,215,212,211,213,244,244
76,679,680,681,680,681,678,678,678,679,680,681,366,124,124,49,124,124,530,531,524,525,526,527,528,529,530,531,244,244
76,716,717,718,717,718,715,715,715,716,717,718,12,13,13,49,748,749,750,751,211,212,213,214,215,215,215,215,244,244
76,753,754,755,754,755,752,752,752,753,754,755,49,902,902,49,785,786,750,788,189,189,189,189,189,189,189,189,189,189
189,189,189,189,189,189,189,189,189,189,189,189,49,902,902,49,822,823,824,825,2,226,226,226,226,226,226,226,226,226
226,76,226,226,226,226,226,226,226,226,226,226,49,902,902,49,859,860,861,862,39,629,633,630,630,630,630,630,630,631
863,76,865,866,865,866,863,863,863,864,865,866,86,87,87,88,261,262,263,264,189,189,189,189,189,189,189,189,189,189
635,76,638,635,635,636,638,635,636,636,637,638,123,124,2,125,11,620,11,620,11,189,11,898,11,189,11,189,189,189
501,76,503,504,505,503,504,505,503,504,505,189,22,23,39,25,48,42,48,42,48,226,48,226,48,226,48,227,77,78
538,76,540,541,542,540,541,542,540,541,542,189,59,60,61,62,85,79,85,79,85,367,85,620,85,620,85,114,114,115
575,76,577,578,579,577,578,579,577,578,579,189,96,97,98,99,122,116,122,116,122,404,122,42,122,42,122,893,903,41
12,13,13,13,13,13,13,14,902,902,902,226,133,134,135,136,159,153,159,153,159,441,159,79,159,79,159,905,40,41
49,404,405,406,403,404,405,51,902,902,902,902,2,226,226,226,196,620,196,620,196,330,196,116,196,116,196,905,40,41
49,441,442,443,440,441,442,51,902,902,902,902,39,299,299,299,233,620,233,620,233,367,233,153,233,153,233,905,40,41
49,330,331,332,329,330,331,51,902,902,902,902,893,893,893,893,893,893,893,893,893,893,893,893,893,893,893,905,40,41
49,450,299,299,299,299,299,51,902,902,902,902,227,227,227,227,227,227,227,227,227,227,227,227,227,227,227,227,227,227
49,227,405,406,403,404,405,51,902,902,902,902,902,902,902,902,902,902,902,902,902,902,902,902,902,902,902,902,902,902
86,87,87,87,87,87,87,88,902,902,902,902,902,902,902,902,902,902,902,902,902,902,902,902,902,902,902,902,902,902
MAP_END
ENTITIES_START
1,9,2
4,1,4,120
11,20,18,29,18,18
11,17,12,13,12,12
11,12,11,6,11,11
11,0,16,12,16,16
11,0,23,7,23,23
11,7,23,7,29,29
11,0,29,0,23,23
7,0,11
7,12,23
9,20,2,5
11,29,3,29,15,15
11,28,15,28,3,3
11,20,15,29,15,15
11,15,18,15,12,12
4,28,2,5
5,7,29
2,12,21
12,20,9,8,20
12,12,4,5,5
12,6,4,5,5
12,3,11,4,6
ENTITIES_END
CONTACTS_START
2,11,120
17,12,5
18,10
CONTACTS_END
../assets/levels/official/_minefield.txt