../assets/tile_sheets/bigTileSheetWarehouseSecurity.txt
MAP_START
113,22,22,894,894,894,894,894,894,904,38
15,16,22,22,22,22,22,244,244,894,38
52,53,22,22,22,22,22,227,227,894,38
89,90,22,22,22,22,22,22,22,894,38
126,127,300,301,300,301,190,22,22,894,38
227,227,227,227,227,227,227,76,76,894,38
22,22,894,894,894,894,22,22,22,894,38
22,22,894,894,894,894,892,22,22,894,38
906,38,894,894,894,894,905,894,894,892,38
227,227,227,227,227,227,227,227,227,227,245
282,283,284,285,286,287,288,289,282,283,282
MAP_END
ENTITIES_START
1,1,0
12,2,8,5,5
12,3,8,4,5
12,4,8,3,5
12,5,8,3,5
6,1,7
2,2,0
11,6,1,2,1,1
10,1,6,1
5,8,7
7,0,7
11,7,7,7,3,3
11,6,3,3,3,3
ENTITIES_END
CONTACTS_START
6,9
10,11
CONTACTS_END
../assets/levels/official/_zelda.txt