../assets/tile_sheets/bigTileSheetWarehouseSecurity.txt
MAP_START
38,897,897,897,897,897,897,897,897,897,897,897,38
38,38,38,38,38,38,897,38,38,38,38,897,38
897,38,38,38,38,906,894,38,904,892,38,897,38
903,894,894,894,894,894,894,894,892,38,38,897,38
897,894,38,894,894,894,894,897,38,38,38,897,38
897,894,894,894,38,894,894,894,38,38,897,897,38
38,894,894,894,897,894,894,894,894,892,897,897,38
38,38,894,894,894,894,38,894,38,38,897,897,38
38,893,894,894,894,894,894,894,38,38,38,38,38
38,38,38,38,38,38,38,38,38,38,38,38,38
MAP_END
ENTITIES_START
1,1,0
2,9,6
4,10,4,1
8,8,6
2,8,3
7,7,3
7,8,2
2,9,2
7,5,2
6,0,5
6,1,8
4,0,1,1
5,6,2
8,6,8
5,4,6
8,7,0
ENTITIES_END
CONTACTS_START
3,4,1
10,9
10,14
11,6
11,7
12,6,1
13,14
15,16
CONTACTS_END
../assets/levels/official/_hellMaze.txt
