../assets/tile_sheets/bigTileSheetWarehouseSecurity.txt
MAP_START
74,74,74,74,74,74,74,74,74,74,74,74,6,7,8,6,7,8,6,7,6,7,7,7,7
74,74,74,74,74,74,74,74,74,74,74,74,43,44,45,43,44,45,43,44,43,44,118,44,44
74,74,74,74,74,74,74,74,74,74,74,74,80,81,82,80,81,82,80,81,80,81,118,118,81
74,74,74,74,74,74,74,74,74,74,74,74,117,118,119,117,118,119,117,118,117,118,44,7,118
74,190,190,190,190,190,74,74,74,74,74,74,154,310,156,154,310,156,154,310,154,155,74,74,155
227,227,227,227,227,227,190,190,190,190,76,74,74,74,74,74,74,74,74,74,74,74,74,74,74
63,64,65,66,67,63,227,227,227,227,76,227,227,227,227,76,76,227,227,227,74,74,74,74,74
100,101,102,103,104,100,101,102,103,104,100,417,900,900,900,0,0,900,900,900,74,74,74,74,74
137,138,139,140,141,137,138,139,140,141,137,417,900,900,900,0,0,900,900,900,74,190,76,190,74
898,898,898,898,898,898,898,898,898,898,903,417,900,900,900,0,0,900,900,900,227,227,76,227,227
26,27,28,29,30,898,27,28,29,30,26,417,0,0,0,0,0,0,0,0,0,0,0,0,0
63,64,65,66,67,898,64,65,66,67,63,417,0,0,0,0,0,0,0,0,0,0,0,0,0
100,101,906,103,104,100,101,102,103,104,100,417,900,900,900,0,0,900,900,900,38,38,128,38,38
137,138,139,140,141,898,138,139,140,141,137,417,900,900,900,0,0,900,900,900,38,166,165,166,165
174,175,176,177,178,898,175,176,177,178,174,417,900,900,900,0,0,900,900,900,38,129,128,129,128
MAP_END
ENTITIES_START
1,1,7
2,2,2
12,7,2,3,5
8,12,5
12,13,8,3,4
12,18,8,3,4
12,18,13,3,4
12,13,13,3,4
2,19,5
6,16,14
7,22,12
2,23,13
5,24,14
8,5,12
6,10,14
ENTITIES_END
CONTACTS_START
10,11
13,4
15,14
CONTACTS_END
../assets/levels/official/_boxManager2k19.txt
