../assets/tile_sheets/bigTileSheetWarehouseSecurity.txt
MAP_START
160,161,160,161,160,161,160,161,160,161
197,198,197,198,197,198,197,198,197,198
79,235,202,203,234,235,202,203,234,79
79,272,239,240,271,272,239,240,271,116
116,897,897,897,897,897,897,897,897,153
153,897,897,897,897,897,897,897,897,153
227,227,227,227,76,76,227,227,227,227
897,897,897,897,897,897,897,897,897,897
897,897,897,897,897,897,897,897,897,897
897,897,897,897,897,897,897,897,897,897
897,897,897,897,897,897,897,897,897,897
897,897,897,897,897,897,897,897,897,897
76,76,227,227,227,227,227,227,76,76
450,450,12,13,13,13,13,14,450,450
450,450,49,900,900,900,900,51,450,450
450,450,49,900,900,900,900,51,450,450
450,450,49,900,900,900,900,51,450,450
450,450,86,87,87,87,87,88,450,450
76,76,227,227,478,479,227,227,76,76
76,76,38,514,515,516,517,38,76,76
897,897,897,551,552,553,554,897,897,897
897,897,897,588,589,590,591,897,897,897
897,897,897,625,626,627,628,897,897,897
897,897,897,662,663,664,665,897,897,897
897,897,897,699,700,701,702,897,897,897
897,897,897,736,737,738,739,897,897,79
226,76,226,226,259,260,226,226,226,79
900,76,900,900,900,900,900,900,900,116
900,903,900,900,900,900,900,900,900,153
900,893,893,893,893,903,893,893,903,906
MAP_END
ENTITIES_START
1,4,4
2,8,24
2,2,5
2,1,23
9,8,19,15
9,9,19,15
12,2,13,4,30
12,7,13,4,5
11,0,25,0,0,0
11,5,11,5,4,4
11,0,7,9,7,7
11,9,8,0,8,8
11,0,9,9,9,9
11,9,10,1,10,10
11,0,11,9,11,11
6,7,17
ENTITIES_END
CONTACTS_START
16,5
16,6
CONTACTS_END
../assets/levels/official/_missileChute.txt