../assets/tile_sheets/bigTileSheetWarehouseSecurity.txt
MAP_START
458,458,458,458,458,458,458,458,458,458,458,458,38,904,904
458,458,458,458,458,458,458,458,458,458,458,892,892,892,892
458,458,458,904,904,904,904,904,458,458,458,458,38,905,905
458,458,458,894,894,894,894,894,38,38,38,38,38,38,38
148,148,893,894,894,894,894,894,458,458,458,458,458,458,458
185,906,38,903,903,903,903,903,458,458,458,458,458,458,458
2,222,38,458,38,38,38,38,38,38,38,38,38,38,38
39,38,38,458,458,38,19,20,21,130,131,132,19,20,21
458,38,38,38,458,38,56,57,58,167,168,169,56,57,58
458,458,458,458,458,38,93,94,95,204,205,206,93,94,95
MAP_END
ENTITIES_START
1,1,4
7,3,3
7,4,3
7,5,3
7,6,3
7,7,3
6,3,4
6,4,4
6,5,4
6,6,4
6,7,4
2,13,0
2,14,1
2,14,2
2,14,0
2,13,2
8,12,1
2,13,1
4,8,0,5
5,2,3
8,1,9
8,3,9
7,0,8
ENTITIES_END
CONTACTS_START
7,2
8,3
9,4
10,5
11,6
19,17,5
CONTACTS_END
