../assets/tile_sheets/bigTileSheetWarehouseSecurity.txt
MAP_START
6,7,8,309,309,309,38,309,309,309
43,44,45,309,309,309,38,309,309,309
80,81,82,309,309,309,309,309,309,309
117,118,119,309,309,309,38,309,309,309
154,155,156,309,309,309,38,309,309,309
906,309,898,309,309,309,38,309,309,309
309,309,309,309,309,309,38,309,309,309
130,131,132,309,309,246,38,309,309,309
167,168,169,309,309,283,38,309,309,309
204,205,206,309,309,309,309,309,309,309
MAP_END
ENTITIES_START
1,4,3
8,6,2
8,5,9
5,6,9
4,4,0,2
5,7,2
11,7,5,9,5,5
8,2,6
ENTITIES_END
CONTACTS_START
4,3
4,2
5,2,2
6,3
6,8
CONTACTS_END
../assets/levels/_level2.txt