../assets/tile_sheets/bigTileSheetWarehouseSecurity.txt
MAP_START
478,479,480,74,74,74,74,74,74,74,74,130,131,132
515,516,517,74,74,74,74,74,74,74,74,167,168,169
552,553,554,74,74,74,74,74,74,74,74,167,168,169
589,906,591,894,894,894,892,893,894,894,894,167,168,169
663,74,628,894,894,894,894,894,894,894,894,204,205,206
894,894,894,894,894,894,894,894,894,894,894,894,892,639
130,131,132,894,894,894,894,894,894,894,894,639,74,639
167,168,169,894,894,894,892,893,894,894,894,639,74,639
167,168,169,74,74,894,74,74,894,74,74,639,74,639
167,168,169,74,74,74,74,74,74,74,74,74,74,639
204,205,206,74,74,74,74,74,74,74,74,74,74,639
MAP_END
ENTITIES_START
1,6,0
12,3,3,5,5
12,3,7,5,5
12,10,3,4,5
12,10,7,4,5
2,5,1
2,8,1
2,6,8
ENTITIES_END
CONTACTS_START
CONTACTS_END
