../assets/tile_sheets/bigTileSheetWarehouseSecurity.txt
MAP_START
38,458,458,458,458,458,458,458,458,458,458,458,458,458,458
38,458,458,458,458,458,458,458,458,458,458,458,894,458,458
38,458,458,904,904,904,904,904,38,458,458,458,894,458,458
38,458,458,894,894,894,894,894,38,38,38,38,905,38,38
148,148,893,894,894,894,894,894,458,458,38,893,905,892,38
185,906,38,903,903,903,903,903,458,458,38,893,905,892,38
2,222,38,458,38,38,38,38,38,38,38,38,38,38,38
39,251,252,458,38,19,20,21,130,131,131,131,132,19,20
458,288,289,458,38,56,57,58,167,168,168,168,169,56,57
458,458,458,458,38,93,94,95,204,205,205,205,206,93,94
MAP_END
ENTITIES_START
1,9,2
7,3,3
7,4,3
7,5,3
7,6,3
7,7,3
6,3,4
6,4,4
6,5,4
6,6,4
6,7,4
6,9,4
7,0,8
2,11,4
2,11,5
2,12,5
2,12,4
2,13,4
2,13,5
3,14,0
7,12,3
2,3,2
2,5,2
2,7,2
ENTITIES_END
CONTACTS_START
7,2
8,3
9,4
10,5
11,6
12,13
20,21
CONTACTS_END
