../assets/tile_sheets/bigTileSheetWarehouseSecurity.txt
MAP_START
0,0,0,0,0,0,0,0,0,0
0,0,0,0,0,0,0,0,0,0
0,0,0,0,0,904,892,0,0,0
894,894,894,894,894,892,905,0,0,0
894,894,894,894,894,0,0,0,0,0
0,0,0,0,0,0,0,0,0,0
0,0,0,0,0,0,0,0,0,0
0,0,0,0,0,0,0,0,0,0
0,0,0,0,0,0,0,0,0,0
0,0,0,0,0,0,0,0,0,0
MAP_END
ENTITIES_START
1,6,5
6,1,3
6,2,3
6,3,3
6,4,3
8,1,4
8,2,4
8,3,4
8,4,4
2,5,4
2,6,4
ENTITIES_END
CONTACTS_START
2,6
3,7
4,8
5,9
CONTACTS_END
