../assets/tile_sheets/bigTileSheetWarehouseSecurity.txt
MAP_START
888,27,28,29,30,26,27,28,29,30
63,64,65,66,67,63,64,65,66,67
100,101,893,893,893,100,904,905,103,104
137,138,892,892,892,137,904,905,140,141
174,175,176,177,178,174,904,905,177,178
26,27,28,29,30,26,27,28,29,30
63,64,65,894,894,894,64,65,895,67
100,101,102,894,894,894,101,102,103,104
137,138,139,894,894,894,138,139,140,141
174,175,176,177,178,174,175,176,177,178
MAP_END
ENTITIES_START
1,4,0
12,9,9,3,5
7,0,7
3,1,5
7,0,3
2,8,1
ENTITIES_END
CONTACTS_START
4,3
4,5
CONTACTS_END
