../assets/tile_sheets/bigTileSheetWarehouseSecurity.txt
MAP_START
0,0,0,0,0,0,0,0,0,0
0,0,0,0,0,0,0,0,0,0
0,0,0,0,0,0,0,0,0,0
0,905,894,894,894,894,894,894,904,0
0,905,894,894,894,894,894,894,904,0
0,905,894,894,894,894,894,894,904,0
0,905,894,894,894,894,894,894,904,0
0,905,894,894,894,894,894,894,904,0
0,905,892,892,892,892,892,892,892,0
0,0,0,0,0,0,0,0,0,0
MAP_END
ENTITIES_START
1,0,0
2,3,1
12,6,5,3,5
12,3,5,3,5
8,5,8
3,8,0
ENTITIES_END
CONTACTS_START
6,5
CONTACTS_END
