../assets/tile_sheets/bigTileSheetWarehouseSecurity.txt
MAP_START
0,0,0,0,0,0,0,0,0,0
0,0,0,0,0,0,0,0,0,0
0,0,904,892,892,892,0,0,0,0
0,0,904,894,894,894,894,905,0,0
0,0,904,894,894,894,894,905,0,0
0,0,904,894,894,894,894,905,0,0
0,0,904,894,894,894,894,905,0,0
0,0,893,893,893,893,893,905,0,0
0,0,0,0,0,0,0,0,0,0
0,0,0,0,0,0,0,0,0,0
MAP_END
ENTITIES_START
1,0,0
2,5,1
7,0,3
7,0,4
7,0,5
3,0,1
ENTITIES_END
CONTACTS_START
6,3
6,4
6,5
CONTACTS_END
