../assets/tile_sheets/bigTileSheetWarehouseSecurity.txt
MAP_START
112,893,904,112,893,904,903,0,0,0,0,0,0,0,0
904,892,893,904,112,892,903,0,0,0,0,0,0,0,0
893,112,904,112,893,904,903,0,0,0,0,0,0,0,0
905,892,112,905,904,112,903,0,0,0,0,0,0,0,0
906,905,893,112,904,904,903,0,0,0,0,0,0,0,0
905,892,112,905,112,904,903,0,0,0,0,0,0,0,0
904,892,905,112,892,904,903,0,0,0,0,0,0,0,0
112,904,905,892,904,112,903,0,0,0,0,0,0,0,0
905,892,892,892,112,892,903,0,0,0,0,0,0,0,0
903,903,903,903,903,903,903,0,0,0,0,0,0,0,0
0,0,0,0,0,0,0,0,0,0,0,0,0,0,0
0,0,0,0,0,0,0,0,0,0,0,0,0,0,0
0,0,0,0,0,0,0,0,0,0,0,0,0,0,0
0,0,0,0,0,0,0,0,0,0,0,0,0,0,0
0,0,0,0,0,0,0,0,0,0,0,0,0,0,0
MAP_END
ENTITIES_START
1,0,0
ENTITIES_END
CONTACTS_START
CONTACTS_END
