../assets/tile_sheets/elliot_testsheet.txt
MAP_START
3,3,3,3,3,3,3,3,3,3,3,3,3,3,3,3,3,3,3,3,3,3,3,3,3,3,3,3,3,3
3,0,0,0,0,0,3,0,0,0,0,0,3,0,0,0,0,0,3,0,0,0,0,0,0,0,0,0,0,3
3,0,0,0,0,0,3,0,0,0,0,0,3,0,0,0,0,0,3,0,0,0,0,0,0,0,0,0,0,3
3,0,0,0,0,0,0,0,0,0,0,0,0,0,0,0,0,0,0,0,0,0,0,0,0,0,0,0,0,3
3,0,0,0,0,0,3,0,0,0,0,0,3,0,0,0,0,0,3,0,0,0,0,0,0,0,0,0,0,3
3,0,0,0,0,0,3,0,0,0,0,0,3,0,0,0,0,0,3,0,0,0,0,0,0,0,0,0,0,3
3,0,0,0,0,0,3,3,3,0,3,3,3,3,3,0,3,3,3,3,3,3,0,3,0,3,0,3,3,3
3,0,0,0,0,0,0,0,0,0,0,0,0,0,0,0,0,0,0,0,0,0,0,0,0,0,0,0,0,3
3,0,0,0,0,0,0,0,0,0,0,0,0,0,0,0,0,0,0,0,0,0,0,0,0,0,0,0,0,3
3,0,0,0,0,0,0,0,0,0,0,0,0,0,0,0,0,0,0,0,0,0,0,0,0,0,0,0,0,3
3,0,0,0,0,0,0,0,0,0,0,0,0,0,0,0,0,0,0,0,0,0,0,3,3,3,3,3,3,3
3,0,0,0,0,0,0,0,0,0,0,0,0,0,0,0,0,0,0,0,0,0,0,3,0,0,0,0,0,3
3,0,0,4,5,5,5,6,0,0,0,0,0,1,1,1,1,1,1,1,1,1,0,3,0,0,0,0,0,3
3,0,0,7,0,0,0,8,0,0,0,0,0,1,0,0,0,0,0,0,0,1,0,0,0,0,0,0,0,3
3,0,0,7,0,0,0,8,0,0,0,0,0,1,0,0,0,0,0,0,0,1,0,3,0,0,0,0,0,3
3,0,0,7,0,0,0,8,0,0,0,0,0,1,0,0,0,2,0,0,0,1,0,3,0,0,0,0,0,3
3,0,0,9,5,0,5,10,0,0,0,0,0,1,0,0,2,2,2,0,0,1,0,3,0,3,0,3,0,3
3,0,0,0,0,0,0,0,0,0,0,0,0,1,0,0,0,2,0,0,0,1,0,0,0,0,0,0,0,3
3,0,0,13,12,12,12,12,0,0,0,0,0,1,0,0,0,0,0,0,0,1,0,0,0,0,0,0,0,3
3,0,0,13,0,0,0,0,11,0,0,0,0,1,0,0,0,0,0,0,0,1,0,0,0,0,0,0,0,3
3,0,0,13,0,0,0,0,11,0,0,0,0,1,1,1,1,1,1,1,1,1,0,0,0,0,0,0,0,3
3,0,0,13,0,0,0,0,11,0,0,0,0,0,0,0,0,0,0,0,0,0,0,3,3,3,0,3,3,3
3,0,0,13,0,0,0,0,11,0,0,0,0,0,0,0,0,0,0,0,0,0,0,3,0,0,0,0,0,3
3,0,0,14,14,14,14,14,11,0,0,0,0,0,0,0,0,0,0,0,0,0,0,0,0,0,0,0,0,3
3,0,0,0,0,0,0,0,0,0,0,0,0,0,0,0,0,0,0,0,0,0,0,3,0,0,0,0,0,3
3,0,0,0,0,0,0,0,0,0,0,0,0,0,0,0,0,0,0,0,0,0,0,0,0,0,0,0,0,3
3,0,0,0,0,0,0,0,0,0,0,0,0,0,0,0,0,0,0,0,0,0,0,3,0,0,0,0,0,3
3,0,0,0,0,0,0,0,0,0,0,0,0,0,0,0,0,0,0,0,0,0,0,3,3,0,3,0,3,3
3,0,0,0,0,0,0,0,0,0,0,0,0,0,0,0,16,0,0,0,15,0,0,3,0,0,0,0,0,3
3,0,0,0,0,0,0,0,0,0,0,0,0,0,0,0,0,0,0,0,0,0,0,0,0,0,0,0,0,3
3,0,0,0,0,0,0,0,0,0,0,0,0,0,0,0,0,0,18,0,0,0,0,0,0,0,0,0,0,3
3,0,0,0,0,0,0,0,0,0,0,0,0,0,0,0,0,0,0,0,0,0,0,3,0,0,0,0,0,3
3,0,0,0,0,0,0,0,0,0,0,0,0,0,0,0,0,0,0,0,0,0,0,3,0,0,0,0,0,3
3,3,3,3,3,3,3,3,3,3,3,3,3,3,3,3,3,3,3,3,3,3,3,3,3,3,3,3,3,3
MAP_END
ENTITIES_START
1,25,5
2,9,3
2,23,2
2,27,12
2,18,26
2,9,16
2,8,23
2,21,2
3,5,0
7,1,6
7,2,6
7,3,6
7,4,6
7,5,6
8,6,3
4,17,0,7
7,15,6
5,27,13
7,26,16
7,24,16
7,28,16
3,26,10
6,25,3
7,24,6
7,22,6
7,26,6
3,23,29
9,25,27,3
9,27,27,5
3,27,21
10,23,25,3
10,23,23,5
11,17,11,17,7
12,17,16,5,10
ENTITIES_END
CONTACTS_START
9,10
9,11
9,12
9,13
9,14
9,15
16,17
18,19
18,20
18,21
22,18
23,24
23,25
23,26
27,28
27,29
30,31
30,32
CONTACTS_END
