../assets/tile_sheets/bigTileSheetWarehouseSecurity.txt
MAP_START
458,458,458,458,458,458,458,458,458,458,458,458,38,904,904
458,458,458,458,458,458,458,458,458,458,458,892,892,892,892
458,458,458,904,904,904,904,904,458,458,458,458,38,905,905
458,458,458,894,894,894,894,894,38,38,38,38,38,38,38
148,148,893,894,894,894,894,894,458,458,458,458,458,458,458
185,906,38,903,903,903,903,903,458,458,458,458,458,458,458
2,222,458,458,38,38,38,38,38,38,38,38,38,38,38
39,458,458,458,458,458,458,458,458,458,458,458,458,458,458
458,458,458,458,458,458,458,458,458,458,458,458,458,458,458
458,458,458,458,458,458,458,458,458,458,458,458,458,458,458
MAP_END
ENTITIES_START
1,1,4
7,3,3
7,4,3
7,5,3
7,6,3
7,7,3
6,3,4
6,4,4
6,5,4
6,6,4
6,7,4
4,8,0,1
2,13,0
2,14,1
2,14,2
2,14,0
2,13,2
8,12,1
2,13,1
ENTITIES_END
CONTACTS_START
CONTACTS_END
