../assets/tile_sheets/bigTileSheetWarehouseSecurity.txt
MAP_START
0,0,0,0,0,0,0,0,0,0
0,0,606,607,0,0,0,0,0,0
0,0,643,644,0,0,0,0,0,0
0,0,0,0,0,0,0,0,0,0
0,0,275,275,0,0,0,0,0,0
0,0,275,275,0,0,0,0,0,0
0,0,0,0,0,0,0,0,0,0
0,0,312,312,0,0,0,0,0,0
0,0,312,312,0,0,0,0,0,0
0,0,0,0,0,0,0,0,0,0
MAP_END
ENTITIES_START
1,0,0
ENTITIES_END
CONTACTS_START
CONTACTS_END
