../assets/tile_sheets/bigTileSheetWarehouseSecurity.txt
MAP_START
26,27,28,29,30,26,27,28,29,30
63,64,65,66,67,63,64,65,66,67
100,101,102,103,104,100,101,102,103,104
137,138,139,904,892,892,138,139,140,141
174,175,176,904,178,174,905,176,177,178
26,27,28,904,30,26,905,28,29,30
63,64,65,893,893,893,905,65,66,67
100,101,102,103,104,100,101,102,103,104
137,138,139,140,141,137,138,139,140,141
174,175,176,177,178,174,175,176,177,178
MAP_END
ENTITIES_START
1,6,3
2,4,3
2,5,3
ENTITIES_END
CONTACTS_START
CONTACTS_END
