../assets/tile_sheets/bigTileSheetWarehouseSecurity.txt
MAP_START
0,0,0,0,0,0,0,0,0,0
0,0,38,38,38,38,38,38,38,0
0,0,894,894,894,894,894,894,38,0
0,0,38,38,38,38,38,38,38,0
0,0,0,0,0,0,0,0,0,0
0,0,0,0,0,0,0,0,0,0
0,0,0,0,0,0,0,0,0,0
0,0,0,0,0,0,0,0,0,0
0,0,0,0,0,0,0,0,0,0
0,0,0,0,0,0,0,0,0,0
MAP_END
ENTITIES_START
1,0,0
12,7,2,3,5
5,6,2
2,2,5
ENTITIES_END
CONTACTS_START
CONTACTS_END
