../assets/tile_sheets/bigTileSheetWarehouseSecurity.txt
MAP_START
162,727,727,894,894,894,894,894,894,904,38
199,163,727,727,727,727,727,191,192,894,38
199,200,727,727,727,727,727,228,229,894,38
236,237,727,727,727,727,727,727,727,894,38
273,274,635,636,638,638,638,727,727,894,38
211,212,213,214,215,215,212,727,727,894,38
727,727,894,894,894,894,727,727,727,894,38
727,727,894,894,894,894,892,727,727,894,38
906,639,894,894,894,894,905,894,894,892,38
245,246,247,248,249,250,251,252,245,246,245
282,283,284,285,286,287,288,289,282,283,282
MAP_END
ENTITIES_START
1,1,0
12,2,8,5,5
12,3,8,4,5
12,4,8,3,5
12,5,8,3,5
6,1,7
2,2,0
11,6,1,2,1,1
10,1,6,1
5,8,7
7,0,7
11,7,7,7,3,3
11,6,3,3,3
ENTITIES_END
CONTACTS_START
6,9
10,11
CONTACTS_END
