../assets/tile_sheets/bigTileSheetWarehouseSecurity.txt
MAP_START
162,727,727,894,894,894,894,894,894,904,0
199,163,727,727,727,727,727,727,727,894,727
199,200,727,727,727,727,727,727,727,894,727
236,237,727,727,727,727,727,727,727,894,38
273,274,635,636,638,638,638,727,727,894,38
211,212,213,214,215,215,212,727,727,894,38
727,727,894,894,894,894,727,727,727,894,38
727,727,894,894,894,894,892,727,727,894,38
727,639,894,894,894,894,905,894,894,892,38
245,246,247,248,249,250,251,252,245,246,245
282,283,284,285,286,287,288,289,282,283,282
MAP_END
ENTITIES_START
1,1,0
12,2,8,3,5
12,3,8,3,5
12,4,8,3,5
12,5,8,3,5
6,1,7
8,1,6
2,2,0
ENTITIES_END
CONTACTS_START
6,7
CONTACTS_END
