../assets/tile_sheets/bigTileSheetWarehouseSecurity.txt
MAP_START
74,74,74,74,74,74,74,74,74,74,74
74,74,74,74,74,74,74,74,74,74,74
74,74,74,74,74,74,74,74,74,74,74
74,74,74,74,74,74,74,74,74,74,74
74,190,190,190,190,190,74,74,74,74,74
227,227,227,227,227,227,190,190,190,190,76
63,64,65,66,67,63,227,227,227,227,76
100,101,102,103,104,100,101,102,103,104,100
137,138,139,140,141,137,138,139,140,141,137
898,898,898,898,898,898,898,898,898,898,903
26,27,28,29,30,26,27,28,29,30,26
MAP_END
ENTITIES_START
1,1,7
2,2,2
12,7,2,3,5
12,0,0,3,5
12,4,0,3,5
ENTITIES_END
CONTACTS_START
CONTACTS_END
