../assets/tile_sheets/bigTileSheetWarehouseSecurity.txt
MAP_START
0,0,0,0,0,0,0,0,417,6,7,8
0,0,0,0,0,0,0,0,417,43,44,45
0,0,0,0,0,0,0,0,417,80,81,82
0,0,0,0,0,0,0,0,417,117,118,119
341,341,341,341,341,341,341,0,416,154,155,156
226,226,226,226,226,226,226,76,226,155,155,155
155,155,155,155,155,155,155,155,898,155,155,155
155,155,155,155,155,155,155,155,898,155,155,155
155,155,155,155,155,155,155,155,155,155,155,155
155,155,155,155,155,155,155,155,898,155,155,155
155,155,155,155,155,155,155,155,898,155,155,155
MAP_END
ENTITIES_START
1,1,8
8,8,8
3,0,0
ENTITIES_END
CONTACTS_START
3,2
CONTACTS_END
