../assets/tile_sheets/bigTileSheetWarehouseSecurity.txt
MAP_START
0,0,0,0,0,0,0,0,0,0
0,0,0,0,0,0,0,0,0,0
0,38,905,904,904,904,904,904,38,38
0,38,905,892,904,904,904,904,38,0
0,38,905,892,892,904,904,904,38,0
0,38,905,892,892,892,904,904,38,0
0,38,905,892,892,892,892,904,38,0
0,38,905,892,892,892,892,892,38,0
0,38,38,38,38,38,38,38,38,0
0,0,0,0,0,0,0,0,0,0
MAP_END
ENTITIES_START
1,9,0
6,2,7
2,3,1
7,0,2
2,4,1
2,5,1
2,6,1
2,7,1
2,8,1
2,1,1
ENTITIES_END
CONTACTS_START
2,4
CONTACTS_END
