../assets/tile_sheets/bigTileSheetWarehouseSecurity.txt
MAP_START
481,482,482,482,482,482,482,482,482,483,189
518,245,246,247,248,249,250,251,252,520,189
518,282,283,284,285,286,287,288,289,520,189
518,189,189,189,189,189,189,189,189,520,189
518,189,189,189,189,189,189,189,189,520,189
632,633,633,631,189,189,629,630,630,634,189
189,19,20,21,904,904,19,20,21,189,189
189,56,57,58,903,903,56,57,58,189,189
189,93,94,95,890,891,93,94,95,189,189
189,189,189,189,189,189,189,189,189,189,189
189,189,189,189,189,189,189,189,189,189,189
MAP_END
ENTITIES_START
1,5,3
3,1,3
7,4,5
7,5,5
2,7,4
ENTITIES_END
CONTACTS_START
0,1
0,2
CONTACTS_END
